w w w w w w w w w w w w w w w w w w w w w w w w w w w w w w w w w w w w w w w w w w w w w w w w w w
w e e e e e e e e e e e e e e e e e e e e e e e e e e e e e e e e e e e e w w w w w w w w e e e e w
w e s e e e e e e e e e e e e e e e e e e e e e w w e e e e e e e e e e e w w w w w w w w e e e e w
w e e e e e e e e e e e e e e e e e e e e e e e w w e e e e e e e e e e e w w w w w w w w e e e e w
w e e e w w w w w e e e e e e e e e e e e e e e e e e e e e e e e e e e e e e e e e e e e e e e e w
w e e e w w w w w e e e e e e e e e w w e e e e e e e e e e e e e e e e e e e e e e e e e e e e e w
w e e e w w w w w e e e e e e e e e w w e e e e e e e e e e e e e e e e e e e e e e e e e e e e e w
w e e e w w w e e e e e e e e e e e e e e e e e e e e w w e e e e e e e e e e e e e e e e e e e e w
w e e e w w w e e e e e e e e e e e e e e e e e e e e w w e e e e e e e e e e e e e e e e e e e e w
w e e e w w w e e e e e e e e e e e e e e e e e e e e e e e e e e e e e e e e e e e e e e e e e e w
w e e e w w w e e e e e e e e e e e e e e e e e e e e e e e e e e e e w w w w e e e e e e e e e e w
w e e e e e e e e e e e e w w w w w w e e e e e e e e e e e w w e e e w w w w e e e e e e e e e e w
w e e e e e e e e e e e e w w w w w w e e e e e e e e e e e w w e e e w w w w e e e e e e e e e e w
w e e e e e e e e e e e e w w w w w w e e e e e e e e e e e e e e e e w w w w w w w w e e e e w w w
w e e e e e e e e e e e e w w w w w w e e e e e e e e e e e e e e e e w w w w w w w w e e e e w w w
w e e e e e e e e e e e e e e e e e e e e e e e e w w w e e e e e e e w w w w w w w w e e e e w w w
w e e e e e e e e e e e e e e e e e e e e e e e e w w w e e e e e e e w w w w w w w w e e e e w w w
w e e e e e e e e e e e e e e e e e e e e e e e e w w w e e e e e e e w w w w w w w w e e e e w w w
w e e e e e e e e e e e e e e e e e e e e e e e e w w w e e e e e e e w w w w w w w w e e e e w w w
w e e e e e e e e e e e e e e e e e e e e e e w w w w w e e e e e e e w w w w w w w w e e e e w w w
w e e e e e e e e e e e e e e e e e e e e e e w w w w w e e e e e e e w w w w w w w e e e e e e w w
w e e e e e e e e e e e e e e e e e e e e e e e e e e e e e e e e e e e e e e e e e e e e s e e e w
w e e e e e e e e e e e e e e e e e e e e e e e e e e e e e e e e e e e e e e e e e e e e e e e e w
w e e e e e e e e e e e e e e e e e e e e e e e e e e e e e e e e e e e e e e e e e e e e e e e e w
w w w w w w w w w w w w w w w w w w w w w w w w w w w w w w w w w w w w w w w w w w w w w w w w w w 