w w w w w w w w w w w w w w w w w w w w w w w w w w w w w w w w w w w w w w w w w w w w w w w w w w
w e e e e e e e e e e e e e e e e e e e e e e e e e e e e e e e e e e e e e e e e e e e e e e e e w
w e e e e e e e e e e e e e e e e e e e e e e e e e e e e e e e e e e e e e e e e e e e e e e e e w
w e e s e e e e e e e e e e e e e e e e e e e e e e e e e e e e e e e e e e e e e e e e e e e e e w
w e e e e e e e e e e e e e e e e e e e e e e e e e e e e e e e e e e e e e e e e e e e e e e e e w
w e e e e e e e e e e e e e e e e e e e e e e e e e e e e e e e e e e e e e e e e e e e e e e e e w
w e e e e e e e e e e e e e e e e e e e e e e e e e e e e e e e e e e e e e e e e e e e e e e e e w
w e e e e e e e e e e e e e e e e w w w w w w w w w w w w w w w w e e e e e e e e e e e e e e e e w
w e e e e e e e e e e e e e e e e w w w w w w w w w w w w w w w w e e e e e e e e e e e e e e e e w
w e e e e e e e e e e e e e e e e w w w w w w w w w w w w w w w w e e e e e e e e e e e e e e e e w
w e e e e e e e e e e e e e e e e w w w w w w w w w w w w w w w w e e e e e e e e e e e e e e e e w
w e e e e e e e e e e e e e e e e w w w w w w w w w w w w w w w w e e e e e e e e e e e e e e e e w
w e e e e e e e e e e e e e e e e w w w w w w w w w w w w w w w w e e e e e e e e e e e e e e e e w
w e e e e e e e e e e e e e e e e w w w w w w w w w w w w w w w w e e e e e e e e e e e e e e e e w
w e e e e e e e e e e e e e e e e w w w w w w w w w w w w w w w w e e e e e e e e e e e e e e e e w
w e e e e e e e e e e e e e e e e w w w w w w w w w w w w w w w w e e e e e e e e e e e e e e e e w
w e e e e e e e e e e e e e e e e e e e e e e e e e e e e e e e e e e e e e e e e e e e e e e e e w
w e e e e e e e e e e e e e e e e e e e e e e e e e e e e e e e e e e e e e e e e e e e e e e e e w
w e e e e e e e e e e e e e e e e e e e e e e e e e e e e e e e e e e e e e e e e e e e e e e e e w
w e e e e e e e e e e e e e e e e e e e e e e e e e e e e e e e e e e e e e e e e e e e e e e e e w
w e e e e e e e e e e e e e e e e e e e e e e e e e e e e e e e e e e e e e e e e e e e e e e e e w
w e e e e e e e e e e e e e e e e e e e e e e e e e e e e e e e e e e e e e e e e e e e e e s e e w
w e e e e e e e e e e e e e e e e e e e e e e e e e e e e e e e e e e e e e e e e e e e e e e e e w
w e e e e e e e e e e e e e e e e e e e e e e e e e e e e e e e e e e e e e e e e e e e e e e e e w
w w w w w w w w w w w w w w w w w w w w w w w w w w w w w w w w w w w w w w w w w w w w w w w w w w